NO ./data/textures/N.png
SO ./data/textures/S.png

WE ./data/textures/W.png
EA ./data/textures/E.png

F 220,100,0
C 225,30,0

111111111
10N001001
100100001
100100101
101100111
111110111
110000011
111111111
