111111111
10P001001
100100001
100100101
101100111
111110111
110000011
111111111
