111111111
100001001
100100001
100100101
1P1100111
111110111
110000011
111111111
