	NO ./data/textures/N.png
		   SO ./data/textures/S.png

                     WE ./data/textures/W.png
EA										./data/textures/E.png
















C 223,0,20
F 100,29,49






      1111111111111111111111111
      1000000000110000000000001
      1011000001110000000000001
      100100000000000000100000111
111111111011000001110000000000001
100000000011000001110111111111111
11110111111111011100000010001
11110111111111011101010010001
11000000110101011100000000001
10000N00000000001100000010001
10000000000000001101010010001
11000001110101011111011110001
11110111 1110101 101111010001
11111111 1111111 111111111111
