	NO ./data/textures/north.png
		   SO ./data/textures/south.png

                     WE ./data/textures/west.png
EA										./data/textures/east.png
















C 10,50,200
F 100,80,123






      1111111111111111111111111
      1000000000110000000000001
      1011000001110000000000001
      100100000000000000100000111
111111111011000001110000000000001
100000000011000001110111111111111
111101       1011100000010001
111                     00001
11000000110101011100000000001
10000000000000000000000010001
10000000N00000001101010010001
11000001110101011111011110001
11110111 1110101 101111010001
11111111 1111111 111111111111
