111111111
100001001
1001000P1
111111111
